1111111111111111111111111111
1PCE000000000000000000000001
1000000011100000011111110001
1000000111000000111111111001
10E0001110000000110000111001
1000011100000000000001110001
1000111001100000E00011100001
1001111111111000000111000001
1001111111111000011110001001
1000000001100000111111111001
1000000001100000111111111001
1000000000000000000000000001
1111111111111111111111111111