11111111111111111111111111111111111111111111111111111111111111111111
1P0C0E00000000000000000000000000000000000000000000000000000000000001
10010110111001110010011101100010001100011111110111111001100000000001
1C000000000000100110011101110111011100001000111100111100100001110001
10010110111000000010001001100111001100111101001100001111111001100001
1C010110111000100100000000000000000000010000000000000000101000000001
10000000000001110110011000100001100101001011100001100101011000000001
1C010110111000000100011101110001110111111000100100011001111000000001
10010110111000100000001000110000110111111000000111100011000011111001
1C010110111001110000000000000000000100001000011100111010000110001001
10000000000000101110001000100000110011110000000011100111111000011001
1C011010011001001010011101110001110001100000000001110000010000110001
10001011001011001110011000110001100011110000000000110000010011111001
1C000000000000000000000000000000000000000000000000000000000000000001
11111111111111111111111111111111111111111111111111111111111111111111