111111111111111111111
11100000111010000C111
100010011111100100111
10P111CCCCCCC01000011
110C1111000C110111C01
111110101E11111001111
111111111111111111111