0000000000000000000000000000
0PCE000000000000000000000000
0000000011100000011111110000
0000000111000000111111111000
0000001110000000110000111000
0000011100000000000001110000
0000111001100000000011100000
0001111111111000000111000000
0001111111111000011110001000
0000000001100000111111111000
0000000001100000111111111000
0000000000000000000000000000
0000000000000000000000000000
