1111111111111111111
1PCE00000000000000000001
100000001110000001111110001
1000000111000000111111111001
1000001110000000110000111001
1000011100000000000001110001
1000111001100000000011100001
1001111111111000000111000001
1001111111111000011110001001
1000000001100000111111111001
1000000001100000111111001
10000000000000000001
111111111111