11111111111111111111111111111
11111000000000000000000000001
11110000001111100001111111C01
11100000000111000011111001101
1100P0000011111000C0111111001
10011000000010000000001110011
10011100000000000000011100011
11011100000000000000001000001
11111111000000000100000000011
11111111000000001100001001111
11111100000001111111001011011
11110000000011011111001011011
11100C000001110E0000001000C11
11000000000011000001111111111
11111111000000000001111111111
10000C01000000000000000000001
10000000000000000000000000001
11111111111111111111111111111