1111111111111111111111111111
1PC0000000000000000000000001
1000000011100000011111110001
1000000111000000111111111001
1000001110000000110000111001
1000011100000000000001110001
1000111001100000000011100001
1001111111111000000111000001
1001111111111000011110001001
1000000001100000111111111111
1000000001100000111111111001
10000000000000000011111000E1
1111111111111111111111111111
